11111
10001
10P01
10001
10C01
10001
1E001
11111