111111111111111111111111
100000000000000000000111
111100101111000000000011
1P0011111111111111000011
111000000000000000C11111
100000000001110000000011
1E0000000011111000001111
111111111111111111111111